BOMBERMAN_LEVEL
15 13
3 3 3 3 3 3 3 3 3 3 3 3 3 3 3
3 5 5 0 0 0 0 0 0 0 0 0 5 5 3 
3 5 1 0 1 0 1 0 1 0 1 0 1 5 3 
3 0 0 0 0 0 0 0 0 0 0 0 0 0 3
3 0 1 0 1 0 1 0 1 0 1 0 1 0 3
3 0 0 0 0 0 0 0 0 0 0 0 0 0 3
3 0 1 0 1 0 1 0 1 0 1 0 1 0 3
3 0 0 0 0 0 0 0 0 0 0 0 0 0 3
3 0 1 0 1 0 1 0 1 0 1 0 1 0 3
3 0 0 0 0 0 0 0 0 0 0 0 0 0 3
3 5 1 0 1 0 1 0 1 0 1 0 1 5 3 
3 5 5 0 0 0 0 0 0 0 0 0 5 5 3
3 3 3 3 3 3 3 3 3 3 3 3 3 3 3